0,3,0,0,0,0,
3,1,3,0,0,0,
0,3,0,3,0,0,
0,0,3,0,3,0,
0,0,0,3,2,3,
0,0,0,0,3,0,