9,9,9,9,9,9,
9,0,0,0,0,9,
9,0,2,0,0,9,
9,1,0,0,0,9,
9,0,0,0,0,9,
9,9,9,9,9,9,