9,9,9,9,9,0,
9,2,0,0,9,0,
9,0,0,0,9,0,
9,1,3,0,9,0,
9,9,9,9,9,0,
0,0,0,0,0,0,