9,9,9,9,9,9,
9,0,0,0,1,9,
9,0,3,0,0,9,
9,0,0,3,0,9,
9,2,0,0,0,9,
9,9,9,9,9,9,